########
####B##
#### ##
### ###
### ###
### ###
##  ###
##A#####